XXXXXXXXXXXXXXXXXXXXXXXXXXXXXXXXXXXXXXXXXXXXXXXXXXXXXXXXXXX
X      @  X                                               X
X         X                                               X
X         X                                               X
XXXXXX XXXX                                               X
X                                                         X
X                                                         X
X                                                         X
X                                                         X
X                                                         X
X                                                         X
X                                                         X
X                                                         X
X                                                         X
X                                                         X
X                                                         X
X                                                         X
X                                                         X
X                                                         X
X                                                         X
X                                                         X
X                                                         X
X                                                         X
X                                                         X
X                                                         X
XXXXXXXXXXXXXXXXXXXXXXXXXXXXXXXXXXXXXXXXXXXXXXXXXXXXXXXXXXX
